XXXXXXXXXXXXXXXXXXXXXXXXXXXXXX
XO     X           X         E
X XXXX X XXXXXXXX  XXXXXXXX  X
X X    X     X            X  X
X X X  X X X X  XXXXXXXXXXX  X
X X X  X X X X  X            X
X X X  X X X X  X XXXXXXXXXXXX 
X   X    X X X  X            X 
X XXXXXX XXX X  XXXXXXXXXXXX X
X            X               X 
XXXXXXXXXXXXXXXXXXXXXXXXXXXXXX
